[
  {
    "type": "map",
    "playerx": 10,
    "playery": -20,

    "xsize": 16,
    "ysize": 16,
    "slices": [
      [
        "::::::::::::::::",
        ":              :",
        ":              :",
        ":              :",
        ":              :",
        ":21111111111111:",
        ":11111111111111:",
        ":11311111111111:",
        ":11131111111111:",
        ":11121111111111:",
        ":11111111111111:",
        ":11111111111111:",
        ":11311111111111:",
        ":11111111111111:",
        ":11111111111111:",
        "::::::::::::::::"
      ]
    ]
  }
]