[
  {
    "type": "map",
    "xsize": 16,
    "ysize": 16,
    "slices": [
      [
        "/               ",
        "/               ",
        "/               ",
        "                ",
        "1111:++:11111111",
        "12111:++:1111111",
        "111111:++:111111",
        "1113111:++:11111",
        "11113111-++:1111",
        "111121111:-+:111",
        "111111111:++:111",
        "111111111:+-:111",
        "111311111:++:111",
        "1111111|:::::::|",
        "1111111|:::::::|",
        "1111111|-------/"
      ]
    ]
  }
]